-1  -1  -1  -1  -1  -1  -1  -1  -1  -1  -1  -1  -1  -1  -1  -1  -1  -1  -1  -1  
-1  -1  -1  -1  -1  -1  -1  -1  -1  -1  -1  -1  -1  -1  -1  -1  -1  -1  -1  -1  
-1  -1  -1  -1  -1  -1  -1  -1  -1  -1  -1  -1  -1  -1  -1  -1  -1  -1  -1  -1  
-1  -1  -1  -1  -1  -1  -1  -1  -1  -1  -1  -1  -1  -1  -1  -1  -1  -1  -1  -1  
-1  -1  -1  -1  -1  -1  -1  -1  -1  -1  -1  -1  -1  -1  -1  -1  -1  -1  -1  -1  
-1  -1  -1  -1  -1  -1  -1  -1  -1  -1  -1  -1  -1  -1  -1  -1  -1  -1  -1  -1  
-1  -1  -1  -1  -1  -1  -1  -1  -1  -1  -1  -1  -1  -1  -1  -1  -1  -1  -1  -1  
-1  -1  -1  -1  -1  -1  -1  -1  -1  -1  -1  -1  -1  -1  51  55  56  56  56  56  
-1  -1  -1  -1  51  55  56  56  56  56  56  56  55  51  -1  -1  -1  -1  -1  -1  
56  56  55  51  -1  -1  -1  -1  -1  -1  -1  -1  -1  -1  55  64  69  69  69  69  
-1  -1  -1  -1  55  64  69  69  69  69  69  69  64  55  -1  -1  -1  -1  -1  -1  
69  69  64  55  -1  -1  -1  -1  -1  -1  -1  -1  -1  -1  56  69  73  70  69  69  
-1  -1  -1  -1  56  69  73  70  69  69  70  73  69  56  -1  -1  -1  -1  -1  -1  
70  73  69  56  -1  -1  -1  -1  -1  -1  -1  -1  -1  -1  56  69  70  61  56  56  
-1  -1  -1  -1  56  69  70  61  56  56  61  70  69  56  -1  -1  -1  -1  -1  -1  
61  70  69  56  -1  -1  -1  -1  -1  -1  -1  -1  -1  -1  55  64  65  59  56  56  
-1  -1  -1  -1  55  64  65  59  56  56  61  70  69  56  -1  -1  -1  -1  -1  -1  
61  70  69  56  -1  -1  -1  -1  -1  -1  -1  -1  -1  -1  51  55  59  65  69  69  
